# Encoding: ISO-8859-1
#
# Mapping from language code to abbreviated language names
# used by jgloss.dictionary.attribute.GairaigoFormatter
#
# Author: Michael Koch <tensberg@gmx.net>
# $Id$

ai=Ainu
ar=Arab.
de=Ger.
el=Greek
en=Engl.
en_US=Amer. Engl.
es=Span.
fi=Fin.
fr=Fr.
it=Ital.
ja=Jap.
je=Jap.-Engl.
jf=Jap.-Fr.
km=Cambodian
ko=Korean
lt=Lat.
ms=Malay
nl=Dutch
no=Norw.
pt=Port.
ru=Russ.
sa=Sanskrit
sv=Swed.
tr=Turk.
zh=Chin.
